1111111111111
1000101100001
10C0000P01101
1C11101C11101
1111111111101
1E100010CC1C1
1111111111111
