1111111111111
11000C01100C1
101001000C011
101001E000001
1P00010001001
1C00010011C01
10C101000C001
1111111111111
